









        				  NO ./path_to_the_north_texture
S ./path_to_the_sprite_texture
111111111111
SO ./path_to_the_south_texture
R 1920 1080
                EA ./path_to_the_east_texture
              					        WE ./path_to_the_west_texture        a
F 220,100,0
C 225,30,0
