R 1920 1080
NO ./path_to_the_north_texture
SO ./path_to_the_south_texture
WE ./path_to_the_west_texture
EA ./path_to_the_east_texture
S ./path_to_the_sprite_texture
F 107,73,132
C 43,47,119

   11111111111
   101100001
   111              
 1110110111111 
   1111111111
          1111