R 1920 1080
NO ./path_to_the_north_texture
SO ./path_to_the_south_texture
WE ./path_to_the_west_texture
EA ./path_to_the_east_texture
S ./path_to_the_sprite_texture
F 220,259,0
C 225,30,0

111111111111111111111111111111111111111
101111111111111111111111111111111111111
101 1111111 111111 111 111       111 11
101 1000001 100001 101 101 111111101 11
111 1000001 100001 101 101 111111101 100001
101 1000001 100001 101 101 11    101 11111111111
111 1000001 100001 101 101 11111 101 110001
111 1111101 111111 101 101 11111 101 110001
111     101        101 101       111 110001
1011111110111111111101110111111110001111111
100000000000000011010100000000000010001
110000011101010111110100000000001110N0111
11110111 1110101 1011100000000001010001
11111111 1111111 111111111111