R 1920 1080
NO ./path_to_the_north_texture
SO ./path_to_the_south_texture
WE ./path_to_the_west_texture
EA ./path_to_the_east_texture
S ./path_to_the_sprite_texture
F 107,73,132
C 43,47,119

11111111111111111111        
101   10000000000001        
101   10000000000001        
10111111111111111101        
10000000000000000001        
10000000000000000001        
10000000000000001001        
10000000000000001001        
10000000000001111001        
10000000000000000001        
10000000000000000001        
10000000000000000001        
11111111111111111111        
