	11111111
	22222222
	1111111111111
	1111111111111
	1111111111111
	11111111111111111
	11111111111111111
	11111111111111111
	11111111111111111
	1111
	1111
	111111111
	111111111
	111111111
    0/      
