R 800 800
NO textures/4.xpm		     
SO         		./textures/3.xpm
WE         		./textures/3.xpm
EA         		./textures/4.xpm
F         		107,73,132			     
C         		43,47,119			     



                 11111111111111111111
                 100000000000000111111
                 1000100000111001    1
                 10000000001 1001    1
                 100000000011100111111
                 10000000000000011111
                 10000001111100101
                 1000001000010001
                 100000100N001001
                 1000001000010001
                 1000000110010001
                 1000000101100011111
                 10000000100000000001
                 10000001111000000001
                 10000001  1000000001
                 10000001  10000100001
                 11111111  1111111111





