R 800 800
NO./textures/bluestone.xpm		     
SO         		./textures/colorstone.xpm
WE         		./textures/eagle.xpm
EA         		./textures/mossy.xpm
F         		107,73,132			     
C         		43,47,119			     



                 11111111111111111111
                 10000000000000000001
                 10001000001110100001
                 10000000001 10000001
                 1000000W001110000001
                 10000000000000011111
                 10000000000000101
                 1000000000000001
                 1000000100000001
                 1000000000100001
                 1000000100000011111
                 10000000000000000001
                 10000001111000000001
                 10000001  1000000001
                 10000001  10000100001
                 11111111  1111111111





