R 800 800
NO         		./textures/bluestone.xpm		     
SO         		./textures/colorstone.xpm
WE         		./textures/eagle.xpm
EA         		./textures/mossy.xpm
S         		./textures/barrel.xpm
F         		107,73,132			     
C         		43,47,119			     

                 11111111111111111111
                 10000000000000000001
                 100020000000002000001
                 10000022200000000001
                 1000002W200000000001
                 10000022200000011111
                 10000000000000201
                 1000000000000001
                 1000000200000001
                 1000000000200001
                 1000000200000011111
                 10000000000000000001
                 10000001111000000001
                 10000001  1000000001
                 10000001  10000200001
                 11111111  1111111111
