R 1280 720
NO textures/harry/4.xpm		     
SO ./textures/harry/8.xpm
WE ./textures/harry/6.xpm
EA ./textures/harry/5.xpm
F 107,73,132			     
C 43,47,119			     



1111111111111111111111111111111111
1000000000000000000W00000000000001
1111111111111111111111111111111111

