R 1280 720
NO textures/mine/1.xpm		     
SO ./textures/mine/2.xpm
WE ./textures/mine/3.xpm
EA ./textures/mine/4.xpm
F 107,73,132			     
C 43,47,119			     



11111111111111111
10000000000000001
10000000000000001
10000000000000001
10000000000000001
10000000000000001
1000000W000000001
10000000000000001
10000000000000001
10000000000000001
10000000000000001
10000000000000001
10000000000000001
11111111111111111





