R 1280 720
NO textures/mine/4.xpm		     
SO ./textures/mine/1.xpm
WE ./textures/mine/2.xpm
EA ./textures/mine/3.xpm
F 055,055,055			     
C 255,194,078			     

11111111111111111111111111111111111111111111111111
10000000000000000000000000000000000000000000000001
10011100011100000010000000000000000000000000000001
1001 10001 100000000000001000000000000000000000001
10011100011100000000000000000000000000000000000001
10000000000000000011100000000000000000000000000001
1000000000000S00001 100000000000000000000000000001
10000011110000000011100000000000000000000000000001
1000001  10000000000000000000000000000000000000001
1000001  10000000000000000000000000000000000000001
10000011110000010000000000000000000000000000000001
10000000000000000000000010000000000000000000000001
10000000000000000000000000000000000000000000000001
10000000000000000000000000000000000000000000000001
10000000000000000000000000000000000000000000000001
10000000000000000000000000000000000000000000000001
10000000000000000000000000000000000000000000000001
10000000000000000000000000000000000000000000000001
10000000000000000000000000000000000000000000000001
10000000000000000000000000000000000000000000000001
10000000000000000000000000000000000000000000000001
10000000000000000000000000000000000000000000000001
10000000000000000000000000000000000000000000000001
11111111111111111111111111111111111111111111111111
